00000000000000000000000000000000
0........................0.....0
0......00000000000....0..0....00
0.000000..........0....00......3
0..................0..0........3
0..000.......0000.....0...00...3
0....000000000.....0...........0
2............0..............0000
2......0000..000.........00....0
2.....00.....000000....00......0
0....0.........00000...........0
00000000000000000000000000000000