0000000000000000000000000
0.......0000.......300000
0...00.............300000
000......0000......300000
00000000000000....0000000
0000000.....00....00...00
4.....0...........000...0
4.P...00...........0....0
4......000.......00.....0
0000..000.....0000......0
0000......M....0000.....0
0000000000000000000000000